Acidipropionibacterium	Propionibacteriaceae
Actinoalloteichus	Pseudonocardiaceae
Actinokineospora	Pseudonocardiaceae
Actinomyces	Actinomycetaceae
Actinoplanes	Micromonosporaceae
Actinopolyspora	Pseudonocardiaceae
Actinosynnema	Pseudonocardiaceae
Actinotalea	Cellulomonadaceae
Actinotignum	Actinomycetaceae
Adlercreutzia	Eggerthellaceae
Aeromicrobium	Nocardioidaceae
Agreia	Microbacteriaceae
Agrococcus	Microbacteriaceae
Agromyces	Microbacteriaceae
Amycolatopsis	Pseudonocardiaceae
Aquiluna	Microbacteriaceae
Arachnia	Propionibacteriaceae
Arcanobacterium	Actinomycetaceae
Arthrobacter_B	Micrococcaceae
Arthrobacter_D	Micrococcaceae
Arthrobacter_F	Micrococcaceae
Arthrobacter_K	Micrococcaceae
Arthrobacter	Micrococcaceae
AWTP1-35	Microtrichaceae
Bifidobacterium	Bifidobacteriaceae
Blastococcus	Geodermatophilaceae
Brachybacterium	Dermabacteraceae
Brevibacterium	Brevibacteriaceae
Catellatospora	Micromonosporaceae
Cellulomonas_A	Cellulomonadaceae
Cellulomonas	Cellulomonadaceae
Cellulosimicrobium	Cellulomonadaceae
Changpingibacter	Actinomycetaceae
Chryseoglobus	Microbacteriaceae
Clavibacter	Microbacteriaceae
Collinsella	Coriobacteriaceae
Corynebacterium	Mycobacteriaceae
Cryobacterium	Microbacteriaceae
Curtobacterium	Microbacteriaceae
Cutibacterium	Propionibacteriaceae
D16-34	Eggerthellaceae
Demequina	Demequinaceae
Dermabacter	Dermabacteraceae
Dermacoccus	Dermatophilaceae
Dermatophilus	Dermatophilaceae
Dietzia	Mycobacteriaceae
Eggerthella	Eggerthellaceae
Fannyhessea	Atopobiaceae
Frankia	Frankiaceae
Frigoribacterium	Microbacteriaceae
Geodermatophilus	Geodermatophilaceae
Georgenia	Actinomycetaceae
Glutamicibacter	Micrococcaceae
Gordonia	Mycobacteriaceae
Gordonibacter	Eggerthellaceae
Gulosibacter	Microbacteriaceae
Herbiconiux	Microbacteriaceae
Ilumatobacter_A	Ilumatobacteraceae
Isoptericola	Cellulomonadaceae
Janibacter	Dermatophilaceae
Jiangella	Jiangellaceae
Kibdelosporangium	Pseudonocardiaceae
Kineococcus	Kineococcaceae
Kitasatospora	Streptomycetaceae
Klenkia	Geodermatophilaceae
Kocuria	Micrococcaceae
Kribbella	Kribbellaceae
Lancefieldella	Atopobiaceae
Lawsonella	Mycobacteriaceae
Leifsonia	Microbacteriaceae
Lentzea	Pseudonocardiaceae
Leucobacter	Microbacteriaceae
Marihabitans	Dermatophilaceae
Marmoricola	Nocardioidaceae
Microbacterium	Microbacteriaceae
Micrococcus	Micrococcaceae
Micromonospora	Micromonosporaceae
Mobiluncus	Actinomycetaceae
Modestobacter	Geodermatophilaceae
Mycobacterium	Mycobacteriaceae
Naasia	Microbacteriaceae
Nakamurella	Nakamurellaceae
Nanopelagicus	Nanopelagicaceae
Nesterenkonia	Micrococcaceae
NM07-P-09	Atopobiaceae
Nocardia	Mycobacteriaceae
Nocardioides	Nocardioidaceae
Nocardiopsis	Streptosporangiaceae
Nonomuraea	Streptosporangiaceae
Oerskovia	Cellulomonadaceae
Ornithinicoccus	Dermatophilaceae
Ornithinimicrobium	Dermatophilaceae
Paenarthrobacter	Micrococcaceae
Paeniglutamicibacter	Micrococcaceae
Palsa-465	Solirubrobacteraceae
Parafannyhessea	Atopobiaceae
Paratractidigestivibacter	Atopobiaceae
Parolsenella	Atopobiaceae
Pauljensenia	Actinomycetaceae
Pedococcus	Dermatophilaceae
Phycicoccus	Dermatophilaceae
Planktophila	Nanopelagicaceae
Plantibacter	Microbacteriaceae
Pontimonas	Microbacteriaceae
Propionibacterium	Propionibacteriaceae
Protaetiibacter	Microbacteriaceae
Pseudonocardia	Pseudonocardiaceae
Rathayibacter	Microbacteriaceae
Rhodococcus	Mycobacteriaceae
Rhodoglobus	Microbacteriaceae
Rhodoluna	Microbacteriaceae
Rothia	Micrococcaceae
Ruania	Beutenbergiaceae
Rubrobacter_D	Rubrobacteraceae
Saccharomonospora	Pseudonocardiaceae
Saccharopolyspora	Pseudonocardiaceae
SCSIO-52915	Rubrobacteraceae
Serinicoccus	Dermatophilaceae
Sinomonas	Micrococcaceae
Specibacter	Micrococcaceae
Spirillospora	Streptosporangiaceae
Streptacidiphilus	Streptomycetaceae
Streptomyces	Streptomycetaceae
Streptosporangium	Streptosporangiaceae
Subtercola	Microbacteriaceae
Thermobifida	Streptosporangiaceae
Thermophilibacter	Atopobiaceae
Tomitella	Mycobacteriaceae
Tropheryma	Microbacteriaceae
Trueperella	Actinomycetaceae
Tsukamurella	Mycobacteriaceae
UBA7748	Atopobiaceae
Xylanimonas	Cellulomonadaceae
